35, 2018-11-14T17:22:23.000Z ,0,535,0,24,506040,18114770,0
36, 2018-11-14T17:22:26.000Z ,707869,5255,23,45,506287,18621057,0
37, 2018-11-14T17:22:29.000Z ,1325892,9559,44,55,506534,19127591,0
38, 2018-11-14T17:22:32.000Z ,1596831,11404,53,196,506781,19634372,0
39, 2018-11-14T17:22:46.000Z ,4672593,32479,155,201,506781,20141153,0
40, 2018-11-14T17:22:56.000Z ,4681041,32622,155,158,506781,20647934,0
41, 2018-11-14T17:23:04.000Z ,4589832,32004,152,13,507028,21154962,0
42, 2018-11-14T17:23:05.000Z ,211349,1989,7,16,507275,21662237,0
43, 2018-11-14T17:23:06.000Z ,453037,3645,15,35,507522,22169759,0
44, 2018-11-14T17:23:08.000Z ,996643,7371,33,28,507769,22677528,0
45, 2018-11-14T17:23:10.000Z ,785166,5921,26,115,508016,23185544,0
46, 2018-11-14T17:23:18.000Z ,3412499,23929,113,25,508264,23693808,0
47, 2018-11-14T17:23:19.000Z ,634175,4887,21,301,508512,24202320,0
48, 2018-11-14T17:23:39.000Z ,4681169,32623,155,175,508264,24710584,0
49, 2018-11-14T17:23:41.000Z ,4680465,32625,155,40,508512,25219096,0
50, 2018-11-14T17:23:42.000Z ,996643,7371,33,49,508760,25727856,0
51, 2018-11-14T17:23:46.000Z ,1419213,10269,47,59,509008,26236864,0
52, 2018-11-14T17:23:50.000Z ,1751790,12545,58,16,509256,26746120,0
53, 2018-11-14T17:23:51.000Z ,422762,3438,14,22,509504,27255624,0
54, 2018-11-14T17:23:52.000Z ,634239,4886,21,33,509752,27765376,0
55, 2018-11-14T17:23:54.000Z ,966496,7164,32,218,510000,28275376,0
56, 2018-11-14T17:24:09.000Z ,4680977,32621,155,122,510000,28785376,0
57, 2018-11-14T17:24:12.000Z ,3442262,24137,114,152,510249,29295625,0
58, 2018-11-14T17:24:22.000Z ,4439353,30968,147,159,510249,29805874,0
59, 2018-11-14T17:24:33.000Z ,4619723,32209,153,51,510249,30316123,0
60, 2018-11-14T17:24:36.000Z ,1359175,9855,45,159,510498,30826621,0
61, 2018-11-14T17:24:46.000Z ,4680401,32624,155,44,510498,31337119,0
62, 2018-11-14T17:24:49.000Z ,1208056,8820,40,78,510747,31847866,0
63, 2018-11-14T17:24:54.000Z ,2295332,16272,76,53,510996,32358862,0
64, 2018-11-14T17:24:58.000Z ,1539801,11097,51,32,511245,32870107,0
65, 2018-11-14T17:25:00.000Z ,845524,6335,28,99,511494,33381601,0
66, 2018-11-14T17:25:06.000Z ,2929315,20618,97,39,511743,33893344,0
67, 2018-11-14T17:25:09.000Z ,1056937,7785,35,72,511992,34405336,0
68, 2018-11-14T17:25:14.000Z ,2144085,15236,71,70,512241,34917577,0
69, 2018-11-14T17:25:18.000Z ,2023113,14409,67,41,512491,35430068,0
70, 2018-11-14T17:25:21.000Z ,1147570,8406,38,18,512741,35942809,0
71, 2018-11-14T17:25:22.000Z ,482928,3852,16,90,512991,36455800,0
72, 2018-11-14T17:25:28.000Z ,2687691,18962,89,35,513241,36969041,0
73, 2018-11-14T17:25:30.000Z ,996707,7371,33,4,513491,37482532,0
74, 2018-11-14T17:25:31.000Z ,60422,953,2,6,513741,37996273,0
75, 2018-11-14T17:25:32.000Z ,150991,1575,5,57,513991,38510264,0
76, 2018-11-14T17:25:34.000Z ,1691048,12132,56,158,514241,39024505,0
77, 2018-11-14T17:25:45.000Z ,4680401,32625,155,46,514241,39538746,0
78, 2018-11-14T17:25:48.000Z ,1268350,9234,42,25,514492,40053238,0
79, 2018-11-14T17:25:50.000Z ,694661,5300,23,17,514743,40567981,0
80, 2018-11-14T17:25:51.000Z ,483312,3852,16,99,514994,41082975,0
81, 2018-11-14T17:25:58.000Z ,2929379,20618,97,137,515245,41598220,0
82, 2018-11-14T17:26:07.000Z ,4046482,28277,134,38,515245,42113465,0
83, 2018-11-14T17:26:09.000Z ,996515,7369,33,13,515496,42628961,0
84, 2018-11-14T17:26:10.000Z ,362404,3023,12,90,515747,43144708,0
85, 2018-11-14T17:26:16.000Z ,2687755,18962,89,66,515998,43660706,0
86, 2018-11-14T17:26:20.000Z ,1902461,13580,63,258,516249,44176955,0
87, 2018-11-14T17:26:37.000Z ,4680465,32624,155,123,516249,44693204,0
88, 2018-11-14T17:26:39.000Z ,3502492,24551,116,43,516501,45209705,0
89, 2018-11-14T17:26:41.000Z ,1147698,8405,38,102,516753,45726458,0
90, 2018-11-14T17:26:48.000Z ,3019756,21240,100,6,517005,46243463,0
91, 2018-11-14T17:26:49.000Z ,60358,953,2,50,517257,46760720,0
92, 2018-11-14T17:26:52.000Z ,1479891,10683,49,108,517509,47278229,0
93, 2018-11-14T17:26:59.000Z ,3171003,22274,105,102,517761,47795990,0
94, 2018-11-14T17:27:05.000Z ,2898656,20412,96,76,518013,48314003,0
95, 2018-11-14T17:27:10.000Z ,2174232,15444,72,85,518265,48832268,0
96, 2018-11-14T17:27:16.000Z ,2476406,17512,82,97,518518,49350786,0
97, 2018-11-14T17:27:22.000Z ,2838874,19995,94,45,518771,49869557,0
98, 2018-11-14T17:27:25.000Z ,1268414,9234,42,99,519024,50388581,0
99, 2018-11-14T17:27:32.000Z ,2898976,20412,96,89,519277,50907858,0
100, 2018-11-14T17:27:38.000Z ,2627269,18548,87,63,519530,51427388,0
101, 2018-11-14T17:27:42.000Z ,1811764,12960,60,38,519783,51947171,0
102, 2018-11-14T17:27:44.000Z ,1056873,7784,35,152,520036,52467207,0
103, 2018-11-14T17:27:55.000Z ,4498751,31382,149,38,520036,52987243,0
104, 2018-11-14T17:27:57.000Z ,996451,7369,33,41,520289,53507532,0
105, 2018-11-14T17:27:59.000Z ,1177269,8613,39,12,520543,54028075,0
106, 2018-11-14T17:28:00.000Z ,301918,2610,10,72,520797,54548872,0
107, 2018-11-14T17:28:05.000Z ,2144149,15236,71,97,521051,55069923,0
108, 2018-11-14T17:28:11.000Z ,2839002,19996,94,45,521305,55591228,0
109, 2018-11-14T17:28:14.000Z ,1207928,8819,40,71,521559,56112787,0
110, 2018-11-14T17:28:19.000Z ,2083151,14823,69,117,521813,56634600,0
111, 2018-11-14T17:28:27.000Z ,3442774,24136,114,166,522067,57156667,0
112, 2018-11-14T17:28:38.000Z ,4680401,32625,155,136,522067,57678734,0
113, 2018-11-14T17:28:46.000Z ,3925190,27449,130,18,522321,58201055,0
114, 2018-11-14T17:28:47.000Z ,332193,2817,11,82,522576,58723631,0
115, 2018-11-14T17:28:52.000Z ,2416176,17100,80,176,522831,59246462,0
116, 2018-11-14T17:29:04.000Z ,4680913,32625,155,298,522831,59769293,0
117, 2018-11-14T17:29:23.000Z ,4680529,32624,155,193,522576,60291869,0
118, 2018-11-14T17:29:26.000Z ,4680913,32625,155,66,522831,60814700,0
119, 2018-11-14T17:29:28.000Z ,1690792,12132,56,111,523086,61337786,0
120, 2018-11-14T17:29:35.000Z ,3291655,23102,109,36,523341,61861127,0
121, 2018-11-14T17:29:37.000Z ,966048,7163,32,60,523596,62384723,0
122, 2018-11-14T17:29:41.000Z ,1751534,12544,58,72,523851,62908574,0
123, 2018-11-14T17:29:46.000Z ,2083599,14823,69,45,524106,63432680,0
124, 2018-11-14T17:29:49.000Z ,1298753,9441,43,57,524361,63957041,0
125, 2018-11-14T17:29:53.000Z ,1630114,11718,54,34,524617,64481658,0
126, 2018-11-14T17:29:55.000Z ,966688,7164,32,45,524873,65006531,0
127, 2018-11-14T17:29:58.000Z ,1298561,9440,43,44,525129,65531660,0
128, 2018-11-14T17:30:01.000Z ,1268222,9235,42,45,525385,66057045,0
129, 2018-11-14T17:30:04.000Z ,1298369,9442,43,143,525641,66582686,0
130, 2018-11-14T17:30:13.000Z ,4227620,29520,140,89,525641,67108327,0
131, 2018-11-14T17:30:19.000Z ,2566847,18134,85,150,525897,67634224,0
132, 2018-11-14T17:30:29.000Z ,4439033,30965,147,347,525897,68160121,0
133, 2018-11-14T17:30:52.000Z ,4680657,32626,155,200,525641,68685762,0
134, 2018-11-14T17:30:53.000Z ,4680913,32623,155,118,525897,69211659,0
135, 2018-11-14T17:30:58.000Z ,3381968,23725,112,94,526153,69737812,0
136, 2018-11-14T17:31:04.000Z ,2748177,19377,91,115,526409,70264221,0
137, 2018-11-14T17:31:11.000Z ,3412051,23932,113,127,526666,70790887,0
138, 2018-11-14T17:31:20.000Z ,3684462,25794,122,51,526666,71317553,0
139, 2018-11-14T17:31:23.000Z ,1449552,10476,48,167,526923,71844476,0
140, 2018-11-14T17:31:34.000Z ,4680593,32625,155,71,526923,72371399,0
141, 2018-11-14T17:31:38.000Z ,1993286,14201,66,20,527180,72898579,0
142, 2018-11-14T17:31:39.000Z ,573689,4474,19,46,527437,73426016,0
143, 2018-11-14T17:31:42.000Z ,1358983,9856,45,18,527694,73953710,0
144, 2018-11-14T17:31:43.000Z ,513395,4060,17,122,527951,74481661,0
145, 2018-11-14T17:31:52.000Z ,3623272,25379,120,13,527951,75009612,0
146, 2018-11-14T17:31:53.000Z ,271771,2404,9,25,528208,75537820,0
147, 2018-11-14T17:31:54.000Z ,724616,5509,24,5,528465,76066285,0
148, 2018-11-14T17:31:55.000Z ,120716,1369,4,2,528723,76595008,0
149, 2018-11-14T17:31:56.000Z ,936029,6957,31,100,528981,77123989,0
150, 2018-11-14T17:32:03.000Z ,3019500,21239,100,25,529239,77653228,0
151, 2018-11-14T17:32:05.000Z ,664450,5095,22,9,529497,78182725,0
152, 2018-11-14T17:32:06.000Z ,241624,2197,8,70,529755,78712480,0
153, 2018-11-14T17:32:10.000Z ,2083983,14824,69,22,530013,79242493,0
154, 2018-11-14T17:32:11.000Z ,604028,4681,20,16,530271,79772764,0
155, 2018-11-14T17:32:12.000Z ,452973,3646,15,178,530529,80303293,0
156, 2018-11-14T17:32:24.000Z ,4680593,32625,155,23,530529,80833822,0
157, 2018-11-14T17:32:28.000Z ,694597,5302,23,0,530788,81364610,0
158, 2018-11-14T17:32:44.000Z ,0,536,0,0,530788,81895398,0
159, 2018-11-14T17:32:46.000Z ,0,536,0,0,531047,82426445,0
160, 2018-11-14T17:32:52.000Z ,0,536,0,0,531306,82957751,0
161, 2018-11-14T17:32:53.000Z ,0,536,0,0,531565,83489316,0
162, 2018-11-14T17:32:54.000Z ,0,536,0,0,531824,84021140,0
163, 2018-11-14T17:33:05.000Z ,0,536,0,0,531824,84552964,0
164, 2018-11-14T17:33:08.000Z ,0,536,0,0,532083,85085047,0
165, 2018-11-14T17:33:09.000Z ,0,536,0,0,532342,85617389,0
166, 2018-11-14T17:33:10.000Z ,0,536,0,0,532601,86149990,0
167, 2018-11-14T17:33:17.000Z ,0,536,0,0,532861,86682851,0
168, 2018-11-14T17:33:25.000Z ,0,536,0,0,533121,87215972,0
169, 2018-11-14T17:33:30.000Z ,0,536,0,0,533381,87749353,0
170, 2018-11-14T17:33:39.000Z ,0,536,0,0,533381,88282734,0
171, 2018-11-14T17:33:44.000Z ,0,536,0,0,533641,88816375,0
172, 2018-11-14T17:33:45.000Z ,0,536,0,0,533901,89350276,0
173, 2018-11-14T17:33:46.000Z ,0,536,0,0,534161,89884437,0
174, 2018-11-14T17:33:47.000Z ,0,536,0,0,534421,90418858,0
175, 2018-11-14T17:33:48.000Z ,0,536,0,0,534681,90953539,0
176, 2018-11-14T17:33:51.000Z ,0,536,0,0,534942,91488481,0
177, 2018-11-14T17:33:56.000Z ,0,536,0,0,535203,92023684,0
178, 2018-11-14T17:34:12.000Z ,0,536,0,0,535203,92558887,0
